6abc Philadelphia	@6abcActionNews
ABC News Australia	@abcnewsaustralia
ABC News Live	@ABCNews
Al Jazeera English	@aljazeeraenglish
Bloomberg Television	@markets
CBS News 24/7	@CBSNews
CNBC	@CNBC
CNBC-TV18	@CNBC-TV18
CNN-News18	@cnnnews18
DW News	@dwnews
Euronews English	@euronews
FOX Weather	@FOXWeather
FRANCE 24 English	@France24_en
GB News	@GBNewsOnline
LiveNOW from FOX	@LiveNOWfromFOX
NASA ISS Live	@nasa
NBC News NOW	@NBCNews
Sky News	@SkyNews
Times Now	@TimesNow
TRT World	@trtworld
WION	@WION
